11111111111111111111111111111111111111111111111111
11111111111111111111111111111111111111111111111111
11111111111111111111111111111111111111111111111111
11111111111111111111111111111111111111111111111111
11111111111111111111111410041111111111111111111111
11111111111111111111114111114111111111111111111111
11114411114411111111001111111411144111144111441111
11111111111111100111111111111141111111111111111111
21111111171111111170011111111114111111711111111113
00000000001100000000000110001100011000011000110000
